00000000
00000000
00000000
00000000
00011000
00200200
03000030
40000004
03000030
00200200
00011000
00000000
00000000
00000000
00000000
00000000
00000000
00000000
00000000
00000000
00000000
00000000
00000000
00000000
00000000
00000000
00000000
00000000
00000000
00000000